
strategic_region={
	id=101
	name="STRATEGICREGION_101"
	provinces={
		49 52 53 54 55 56 57 58 59 60 61 62 63 64 65 66 67 78 92 97 107 108 109 110 
		112 117 124 132 134 136 140 144 158 163 183 185 195 197 212 216 218 223 225 
		236 237 239 242 250 259 262 270 271 272 283 285 291 292 299 305 306 310 319 
		320 321 339 345 350 361 375 385 386 387 398 420 445 463 464 468 480 485 493 
		511 512 517 536 537 538 582 583 589 621 647 665 670 681 687 696 714 746 747 
		768 798 814 835 839 840 877 894 907 911 935 973 974 990 1005 1029 1052 1075 
		1100 1117 1118 1155 1162 1163 1175 1199 1211 1223 1268 1279 1292 1293 1347 
		1362 1402 1408 1434 1460 1468 1477 1484 1493 1514 1525 1616 1649 1650 1697 
		1763 1826 1877 1886 1895 1944 1945 1971 2137 2142 2279 2457 2458 2623 2690 
		2704 2853 2858 2912 2984 2987 2994 3025 3038 3096 3106 
	}
	naval_terrain=water_deep_ocean
	weather={
	}
}
