
strategic_region={
	id=103
	name="STRATEGICREGION_103"
	provinces={
		2769 2675 2523 2751 2746 2123 2509 2398 2092 1839 1872 1891 1365 1528 1601 1504 
		1190 984 806 682 628 530 719 873 378 415 317 1846 1911 2276 2574 2496 2181 
		2575 2381 2287 1184 838 945 1575 2191 1853 2024 978 1280 1595 1236 961 2173 713 
		677 442 567 2159 2109 1953 1274 1481 1087 1201 414 503 774 427 1015 801 983 649 
		526 899 1080 1191 1709 1583 1380 1431 1088 1611 1954 1102 740 481 346 575 344 
		247 314 333 373 611 279
		311 # island
		494 147 679 266 176 189 87 94 1 2 3 4 219 211 151 89 255 941 813 1792 1673 1386 
		560 448 576 341 1116 1371 1569 737 496 607 303 438 1370 917 914 606 495 431 
		359 334 388 381 612 482 1108 1381 766 545 395 301 267 369 302 290
		
		# pacific between hawaii and south america
		233 308 358 298 282 149 100 135 122 208 280 340 331 356 304 226 286 251 137 12 83
		165 19 231 11 161 182 166 88 14 17 18 154 207 229 13 15 22 80 23 256 177 196 
		198 244 20 217 123 191 312 25 21 16 126 178 268 26 27
		
		# more specifically central american coast
		234 221 128 115 113 202 28 29 30 31 32 33 34 35 36 101 116 180 
	}
	naval_terrain=water_deep_ocean
	weather={
	}
}
