2 11 5731 2189 2406 6223 2073 1982 1956 2449 5762 3540 2414 
2 2 2041 1956 
2 8 5731 2422 5717 2376 1618 5265 2311 2232 
1 6 1730 2339 1807 2121 2422 5731 
1 6 1956 1788 2365 2366 2035 1730 
2 7 2414 3532 5761 5760 2364 2420 2001 
3 2 3432 2203 
1 6 2601 2600 1677 1777 2561 1707 
1 5 1707 2493 2251 2443 2406 
1 5 5731 1587 2465 6225 2522 
1 2 1787 1777 
2 10 5731 3533 2367 5727 5722 3526 5710 5708 3507 3498 
2 2 2176 2203 
2 2 2176 2162 
2 6 2176 5693 5694 5696 3428 3433 
2 7 3478 3481 3479 3480 3482 3487 3498 
1 3 6225 5612 2528 
1 4 2528 2544 1628 2601 
2 5 5722 3531 5728 5729 3442 
2 4 5732 5735 5737 2456 
3 4 6468 5725 2394 5719 
3 2 3443 5725 
3 3 3443 5733 5736 
2 3 5715 3441 5720 
1 6 5715 2377 3525 3521 3520 5710 
1 5 3484 3489 5705 5706 3521 
1 8 5731 3533 3528 3517 3519 3513 2314 3498 
1 4 3517 2256 3496 2311 
2 7 2232 5245 6397 5698 5689 5695 2161 
3 5 2232 6396 3431 2161 3473 
1 2 3430 3431 
2 3 2104 5686 3473 
1 2 3473 2162 
1 3 5698 3477 3475 
2 3 5697 3479 3480 
3 3 5719 3522 3516 
1 10 3516 2304 3437 3501 3440 2271 3439 5703 5702 3438 
2 7 3516 3515 3510 2384 2315 3509 5704 
1 2 3506 3510 
1 2 2304 3504 
1 3 2296 2317 2315 
1 6 5704 3491 2278 5699 2270 3484 
1 4 5706 3508 3500 3509 
2 5 2315 5707 3518 5711 5715 
1 3 3516 3511 3501 
1 3 3489 3502 3498 
1 5 1730 6220 6219 6222 2073 
1 5 2041 5742 2472 1675 1707 
1 6 2041 5764 2010 5763 3543 2414 
1 5 3498 3495 3486 2233 3479 
1 3 6247 6253 2685 
1 3 6247 6243 2528 
1 3 2614 6254 6257 
1 4 2614 6240 2578 6232 
1 4 6240 5617 6230 2528 
1 6 5722 3529 2454 3542 3545 6225 
1 4 2522 5611 2455 2456 
1 3 6247 2621 2614 
1 8 2456 2513 2526 5616 2578 6244 2643 3690 
1 3 6232 5614 2513 
1 2 5617 2526 
1 3 2456 5739 5736 
2 6 5736 2694 2741 2495 6233 2573 
1 4 6232 5613 2741 2495 
1 4 2578 2847 2875 2495 
1 2 6257 8046 
1 2 3690 6257 
2 5 2573 2632 2602 2273 3780 
2 3 3780 3782 3781 
1 6 8046 2731 2701 5630 2645 2632 
1 8 2645 2714 5518 3789 3788 3784 2689 3781 
1 4 2104 5226 5687 3475 
2 3 2104 3471 3469 
1 6 2104 5685 3468 3467 3465 2014 
2 5 5927 3466 3464 5682 2014 
1 3 5927 3466 3469 
1 2 2014 3462 
1 4 2014 5679 3425 3424 
1 3 2014 3463 3461 
1 5 3467 2072 5683 5681 3462 
1 2 3469 3467 
2 5 5687 5688 2193 5695 2161 
1 4 5687 2139 3472 3469 
1 6 2035 2303 5262 5247 5241 3475 
3 2 5927 2078 
2 2 2103 5220 
2 7 5220 5224 5225 5229 2147 5222 5687 
2 3 5222 3909 5157 
3 3 2078 5154 5152 
2 8 5220 2132 5230 5223 2112 5165 5168 4850 
2 7 2103 5211 5215 5156 3908 5157 2078 
1 8 3644 5180 2300 2217 5173 5170 5166 4850 
2 9 2001 5267 5263 5257 2248 5246 5238 5228 5220 
1 7 5257 5266 5260 5270 2301 5179 3644 
1 7 5260 5248 2218 5172 2198 5171 5168 
2 6 5152 3427 5141 1987 5121 3896 
1 2 5121 1924 
1 3 1987 3901 5117 
1 3 3896 1884 5104 
1 2 3896 5106 
2 5 3427 3426 5145 8288 1948 
2 4 1948 3900 8284 3421 
2 4 1948 8283 8278 3895 
1 4 3421 8280 8278 3895 
1 6 5138 2007 2061 5206 5210 2103 
1 6 1948 5137 5142 8290 2061 5206 
2 2 3900 5129 
1 6 5146 2059 5200 2113 5221 5230 
1 12 5129 3904 5138 3907 5146 1997 3906 5198 5153 2111 5163 4850 
1 5 5106 5102 3893 5191 1782 
2 7 5129 3898 1894 5373 5372 5445 5441 
1 8 1894 3902 5456 5131 5134 1920 3905 5124 
1 2 3905 1986 
1 4 5444 5097 5098 1843 
1 4 5444 4982 5440 5370 
2 4 5370 1813 5442 5441 
1 4 5372 5452 1883 5451 
2 6 5441 5369 5360 1695 5353 5427 
2 4 5427 5428 5183 1696 
1 2 1696 5185 
1 2 1696 5184 
1 3 5183 5182 1695 
1 4 5441 5190 1755 5192 
1 3 1755 5188 5187 
1 3 5196 1830 5192 
1 8 5427 5608 5351 5350 1694 5349 5348 5607 
1 3 5370 5368 5361 
1 3 5361 5357 5350 
1 3 5361 5356 5348 
1 3 5354 5355 5359 
1 10 5355 4971 5431 5434 5433 5432 1762 5437 5438 4982 
2 3 5103 5096 1842 
1 5 2495 5503 5507 2656 2645 
2 9 3781 3783 5516 3786 2739 2710 5624 2634 5505 
1 13 1843 5116 5115 5122 7659 3933 7674 7683 7554 2052 7561 7629 7628 
2 3 5082 1781 1842 
1 3 5148 5155 2053 
1 4 5155 5159 2058 5153 
2 6 5103 3928 7544 1917 7546 7674 
1 3 1986 8187 5153 
1 2 5082 5434 
1 5 5122 5128 5130 5125 5124 
2 4 5339 1597 2340 5335 
1 5 5339 1577 5337 1507 5599 
1 4 5339 5424 2280 5608 
2 4 5335 5604 5605 5427 
1 3 5335 5330 5419 
1 3 5339 5413 5322 
1 6 5335 5328 1494 5325 5409 1449 
1 3 5322 5407 1449 
1 4 1449 5406 5410 5408 
1 4 5410 1495 5326 5327 
1 5 5419 5421 5423 5425 5428 
2 6 5339 5341 5338 2219 1586 5601 
1 2 5607 2219 
1 4 5601 5415 5600 5596 
1 2 5596 1540 
1 5 1540 5602 1585 3824 1647 
2 2 1647 3821 
2 4 1647 3834 3836 1648 
2 9 5339 1577 5334 5411 5405 5318 5310 1448 1373 
1 6 5596 1488 5319 5309 1447 1373 
1 4 5305 5309 2200 5599 
2 3 1373 5301 5589 
1 3 1373 5592 5399 
1 4 5399 5400 5401 5396 
1 3 5399 5397 1346 
2 6 1256 5287 5290 5395 5586 5589 
2 4 5596 5499 5317 5308 
2 5 5308 1301 1341 1690 1737 
1 3 1737 1705 5404 
2 9 1657 5280 1174 5283 5285 1229 1805 1228 1737 
1 6 5589 5296 5293 5292 5291 1805 
1 2 1301 1327 
1 4 5386 5582 1112 1215 
1 3 5582 5279 1657 
1 3 1757 5390 1215 
1 2 1757 5584 
1 4 1757 1758 5388 5581 
1 3 1757 2810 1147 
2 3 1757 5392 1805 
1 7 5386 5385 1081 5580 2822 1635 5581 
1 4 1017 6452 1104 1635 
1 3 5584 2687 2636 
2 7 1017 5485 5576 1028 5275 1022 5274 
1 5 1022 5277 5278 1756 5386 
1 7 5383 4838 5487 1069 1012 5484 1017 
1 2 1028 2822 
1 12 701 3460 767 822 2213 2272 5478 5479 5480 5483 5381 1022 
1 2 5381 5482 
1 3 928 5379 5381 
1 5 720 5477 5572 5573 5376 
2 3 851 5376 5479 
3 3 2078 5158 3469 
1 3 5146 4991 5456 
1 3 5451 5450 5444 
1 5 1842 5091 5089 5085 5437 
1 7 1648 5430 1692 5429 5432 1762 5437 
1 3 5124 5112 5450 
2 5 5122 5115 1899 5100 1842 
2 17 7628 7567 7572 7580 7584 7591 7586 7585 3967 2136 7590 3974 7599 2192 4851 5166 4850 
2 3 3974 3980 7541 
3 3 3987 7540 7541 
2 6 2310 7605 7600 7597 7595 7591 
2 6 7628 7627 7624 7626 7622 3947 
2 2 3947 7623 
2 3 3947 7617 3936 
2 5 7623 2006 7621 7692 4846 
2 10 7721 7716 2186 7640 7568 3973 3969 7588 3966 7591 
1 8 2310 7609 7642 2247 7604 3981 7724 7721 
2 4 7591 3976 7537 3987 
2 8 3936 3932 1961 3938 3939 1991 7625 7628 
1 15 1961 7549 7616 7551 1993 3940 7674 1962 3945 7560 3950 7571 7579 7581 2136 
1 5 2053 7574 3968 7592 3974 
1 6 5180 3996 7611 7610 7542 7541 
1 5 7599 3978 7606 3988 3996 
1 2 3978 5173 
1 5 5148 7559 2021 7558 3945 
1 3 3963 7631 2006 
2 3 4846 7698 7696 
2 8 7721 3975 7715 7714 7708 7703 2083 7696 
2 9 7696 7690 2036 4844 1975 7782 6458 7781 1990 
2 7 7696 7685 7675 7663 7653 616 1811 
3 4 2283 7736 7737 3913 
1 8 7736 7731 7726 7720 7717 2118 7705 3962 
1 4 7714 7710 4849 3962 
1 4 3913 7734 7735 3990 
1 6 3990 7732 4000 7728 7722 7721 
1 6 3913 2246 7718 3971 3972 7714 
1 5 4846 7694 7691 7689 7675 
2 4 7675 4840 1936 1851 
2 2 3936 1851 
1 3 4870 8065 1834 
1 12 1811 7644 7645 631 1834 1841 7646 7760 1893 7764 7758 7763 
1 7 1834 7648 7651 623 7662 7680 2036 
2 4 3913 7738 3993 7847 
3 3 2283 3915 3916 
2 11 2283 7827 3912 7820 5006 7814 5000 7801 6459 7788 6458 
2 11 1990 7777 7770 7763 4986 7750 1537 1574 7742 2143 2264 
2 3 1990 1428 7802 
1 12 3962 7705 7702 7799 7801 7797 7802 7800 7803 2101 7804 7806 
1 5 7736 7818 2211 7814 7816 
2 6 5005 5003 2174 2153 7817 8134 
2 5 7827 2268 7822 7816 5005 
2 2 3912 7736 
2 2 3915 7827 
2 4 7802 4998 7809 5005 
1 5 7802 1394 7805 7812 7814 
2 5 7763 7767 7766 7762 7761 
1 5 7763 1882 7773 7778 6458 
2 9 5005 5012 7824 7829 2309 7834 7842 3862 2418 
1 5 3915 7833 7838 7836 7834 
1 4 7829 7826 7825 8134 
1 9 7802 7800 7792 7784 4989 7779 7775 7769 7761 
3 5 2310 7846 3995 3997 7870 
3 3 3995 5714 7873 
3 4 7870 2405 5716 7873 
2 7 7870 7880 7881 5726 7893 2441 3699 
1 7 3411 7883 7886 7887 7895 7977 7979 
1 5 3411 7884 7877 7974 7870 
2 7 7870 6465 6469 6471 7903 7910 6482 
1 5 7910 2464 7976 5723 7881 
1 3 7976 7898 2441 
1 6 6482 7984 7918 3550 7997 7929 
3 3 2232 3676 3432 
2 2 3516 2316 
3 2 5719 5720 
3 4 3442 5724 6464 5719 
3 2 5732 6464 
3 2 3432 3434 
3 2 3478 3432 
1 2 3886 3890 
1 3 7969 7968 3840 
1 8 3840 7966 7967 7964 7957 7950 7943 4004 
1 4 7935 7930 5619 7924 
1 3 2610 7996 7924 
1 3 7924 7991 7916 
1 5 6484 6481 7985 7915 7916 
1 6 7916 7911 7908 7900 7892 3411 
1 4 7916 7909 2491 7910 
2 10 7847 7848 3994 7973 2331 7869 7874 2390 7879 3411 
1 8 7847 7857 7863 2330 7878 7882 7897 7979 
1 5 4004 7937 3876 3869 6500 
2 4 3916 6467 6470 6472 
2 5 6472 3863 2419 3864 2418 
2 2 6472 6474 
1 5 6472 6475 3866 6483 6489 
2 5 2418 6478 6487 2543 3918 
2 4 3918 6497 6498 6500 
1 6 3886 2716 2608 3874 6499 3918 
1 5 3886 3884 2715 2642 3875 
2 2 2659 3875 
1 2 3875 2576 
1 7 2576 3871 2551 3868 6492 6496 3918 
1 5 2576 4002 3865 2474 2418 
2 7 2310 7605 3979 3982 7539 3986 3987 
1 3 1688 8056 2143 
2 4 1851 8082 1869 1774 
2 3 1869 8080 4983 
1 2 4983 1774 
1 4 1851 1908 7552 1811 
2 3 1811 8068 1610 
2 5 1610 2274 8057 1773 4870 
2 4 4870 8059 2281 2143 
1 7 2264 8052 6209 6210 6211 2126 1610 
1 2 1688 6199 
2 3 4983 8073 1811 
2 4 1774 8070 3047 2201 
1 3 2201 1770 8068 
2 5 1774 8075 8076 8078 1819 
1 4 3932 1927 8081 1869 
1 3 1819 7612 7544 
1 5 1774 2116 2292 4973 5359 
2 6 2201 1703 8055 3831 1622 3821 
2 3 3821 3816 1533 
2 4 1533 3828 3827 1591 
1 2 6209 3835 
1 3 3835 3829 1591 
1 3 2264 1584 1532 
1 2 2365 2001 
1 4 6199 6196 1531 3804 
2 5 3804 6188 3805 1518 1532 
1 2 6199 1532 
2 4 1532 3818 3819 1591 
1 7 1591 3820 1524 6194 3810 3813 3811 
1 3 5404 1459 3811 
1 7 1532 3806 3807 3808 3809 1476 6614 
1 2 3809 1524 
1 3 3811 1534 3821 
1 6 1610 4970 8053 1631 3830 1533 
2 3 6614 2433 2178 
1 3 2178 1443 3806 
1 2 2298 6553 
2 4 2298 6559 1345 2433 
1 3 2298 6550 6552 
1 5 2298 2400 6555 1340 5829 
1 6 6614 6567 6562 2334 1474 5404 
1 7 2298 6601 2533 2341 6556 1713 1737 
1 5 6553 6597 2507 6544 6533 
1 3 6533 1206 2636 
1 9 6576 5491 6517 4561 6522 6526 6532 2603 6533 
1 4 6533 2646 1139 2725 
1 5 5491 4558 6580 6584 1179 
1 5 6532 2564 2459 6541 6540 
1 4 6576 1074 6573 6572 
1 2 6572 6575 
1 3 4561 5493 5383 
1 3 6575 1060 5940 
1 5 1059 5938 5946 4563 1173 
1 3 5829 5826 6540 
1 4 5832 6611 1372 5829 
1 6 5832 6613 6610 6606 5828 5825 
1 2 1366 5828 
1 2 3804 5832 
1 7 5832 6609 5830 5827 1305 6596 6538 
2 6 5829 1364 1479 1299 1323 6538 
1 3 6590 6537 6538 
1 3 6590 6536 5825 
1 6 6583 6579 5951 5943 5937 4585 
1 4 6583 6586 6588 6538 
1 4 6540 5819 5814 1173 
1 3 6538 6539 6540 
1 4 6552 2460 6551 6540 
1 3 4927 5815 6583 
1 4 6583 5816 1510 1173 
2 3 5928 4585 4569 
1 2 4569 1058 
1 4 4569 5947 5813 5815 
2 2 1003 4585 
1 3 1173 4575 6580 
1 2 1366 8029 
1 2 5928 5940 
1 2 1059 5928 
2 3 1003 964 4571 
1 2 4571 2097 
1 2 2097 2125 
1 3 2125 2039 5936 
1 3 5936 5948 2870 
1 6 2125 5930 997 2016 5929 2563 
1 5 2870 2917 5954 5953 6064 
1 3 5960 5957 5954 
1 3 5960 5958 5954 
1 3 5960 2842 4935 
1 6 2927 5959 2876 4933 1241 2842 
1 4 2870 1167 5956 4933 
1 3 4933 2832 1319 
1 4 2927 5961 2698 6536 
1 2 3804 1424 
1 3 2673 1870 2927 
1 3 2563 1004 6021 
1 2 4569 969 
1 4 2039 5941 2562 2620 
1 4 4927 1132 4926 2870 
